tpsBalle 5
coDepart 9 2
nbBalles 1 :
co 8 5 dir 0
0E000000E0
0F000000F0
A0DD00DD0A
00B0000B00
0000ADA000
0000C0D000
AA00ADA0AA
00B0000B00
GGDD00DDGG
0000AA0000