tpsBalle 5
coDepart 1 1
nbBalles 1 :
co 1 2 dir 0
A000000000
B000000000
C000000000
D000000000
E000000F00
F00000HG00
G000000000
H000000000
00D0000000
0000D00000