tpsBalle 5
coDepart 9 2
nbBalles 1 :
co 8 8 dir 0
0A000HH0F0
BDEE0000C0
0000HBCEG0
000000A000
00CEFB00FH
0D000B0000
0B0000EDAA
0D000000BA
0BE000CCCA
0D0G000C00