tpsBalle 5
coDepart 9 2
nbBalles 1 :
co 8 8 dir 0
0A000HH0F0
BDEE0000A0
0000HBHHE0
B00000A000
00CEFB00FE
0B000B0000
0D0HE0EDAA
0B00E000BA
0DE0EEDDdA
0B0GH0BD00