tpsBalle 1
coDepart 9 2
nbBalles 1 :
co 1 5 dir 0
0A000HH0F0
BDEE0000C0
0000HBCEG0
000000A000
00CEFB00FE
0B000B0000
0D0000EDAA
0B000000BA
0DE0000DDA
0B0G000D00