tpsBalle 5
coDepart 1 1
nbBalles 1 :
co 1 2 dir 0
00000GH000
00CC000000
0000000000
00000AA000
0000000000
0000000000
000CC00000
00BB000000
00000AAA00
0000000000